=
M
0000000000000000000000000000
0000000000000000000000000000
00AAAAAA0BBB0CCCCC0DDDDDDD00
00AAAAAA0BBB0CCCCC0DDDDDDD00
00AAAAAA0BBB0CCCCC0DDDDDDD00
00AAAAAA0BBB0CCCCC0DDDDDDD00
00AAAAAA0BBB0CCCCC0DDDDDDD00
00AAAAAA0BBB0CCCCC0DDDDDDD00
00AAAAAA0BBB0CCCCC0DDDDDDD00
0000PP000BBB0CCCCC0DDDDDDD00
00EEEEEE0BBB00PP00000PP00000
00EEEEEE0BBBBBBBBBBBBBBBBB00
00EEEEEE0BBBBBBBBBBBBBBBBB00
00EEEEEEPBBBBBBBBBBBBBBBBB00
00EEEEEEPBBBBBBBBBBBBBBBBB00
00EEEEEE0BBBBBBBBBBBBBBBBB00
00EEEEEE0BBBBBBBBBBBBBBBBB00
00EEEEEE0BBBBBBBBBBBBBBBBB00
0000000000000000000000000000
0000000000000000000000000000
B
0000000000000000000000000000
0000000000000000000000000000
0011111101110111110111111100
0011111101110111110111111100
0011111101110111110111111100
0011111101110111110111111100
0011111101110111110111111100
0011111101110111110111111100
0011111101110111110111111100
0000110001110111110111111100
0011111101110011000001100000
0011111101111111111111111100
0011111101111111111111111100
0011111111111111111111111100
0011111111111111111111111100
0011111101111111111111111100
0011111101111111111111111100
0011111101111111111111111100
0000000000000000000000000000
0000000000000000000000000000
|
f1aA4:2
f2aD21:2
f3bE4:16
f4dE3:16
f5dE6:16
sB11:10
td9:2
tu11:2